111111111111111311111111111111111
100000000000000000000000000000001
100050000000000000000000000050001
100000040000000000000000400000001
100050000000000000000000000050001
100000000000000000000000000000001
111111111000000000000001111111111
000000001000000500000001000000000
000000001000000000000001000000000
000000001000000200000001000000000
000000001111111111111111000000000