11111111111111111111111111111111111
10000500000000005000000000500000001
10000000000000000000000000000000001
12000000400000004000000004000000003
10000000000000000000000000000000001
10000500000000005000000005000000001
10011111111111111111111111111111001
10000000000000000000000000000000001
10000000000000005000000000000000001
10000000000000000000000000000000001
11111111111111111111111111111111111