111111111111111111111111111111111
100000000000000000000000000000001
100050000000000000000000000050001
120000040000000000000000400000001
100050000000000000000000000050001
100000000000000000000000000000001
111111111111110040011111111111111
100000000000000000000000000000001
100050000000000000000000000050001
100000040000000000000000400000001
100050000000000000000000000050001
100000000000000000000000000000001
111111111111111131111111111111111